1111111
1P0C001
1000001
1111101
1C00E11
1111111
