111111
1P0001
111101
1C0CE1
111111
