1111111111111111111111111111111111111111
1P00000000000000000000000000000000000001
1001111111111111111111111111111111111001
1000000000000000000000000000000000000001
1111111111111111111111111111111111111111
1000000000000000000000000000000000000001
1111111111111111111111111111111111111001
100000000000000000000000000000000000C001
1111111111111111111111111111111111111001
100000000000000000000000000000000000C001
1111111111111111111111111111111111111001
100000000000000000000000000000000000C001
1111111111111111111111111111111111111001
1000000000000000000000000000000000000001
1111111111111111111111111111111111111111
1000000000000000000000000000000000000001
1001111111111111111111111111111111111001
1000000000000000000000000000000000000001
1001111111111111111111111111111111111001
1000000000000000000000000000000000000001
1111111111111111111111111111111111111001
1C00000000000000000000000000000000000E01
1111111111111111111111111111111111111111