111111
1P0C01
10X001
1C00E1
111111
