1111111
1P0C001
1011101
1C011E1
1111111
