111111
1P1C11
111101
1C11E1
111111
