111111
1P0C01
1000E1
1C00E1
111111
