111111
1P0C01
1P0001
1C00E1
111111
