111111
PP0C01
100001
1C00E1
111111
