1111111
1P000E1
1111101
1C11111
1111111
