111111
1P0C01
10	001
1C00E1
111111
