111111
1P0C01
000001
1C00E1
111111
