110111
1P0C01
100001
1C00E1
111111
