111111111111111111111111111111
1E0000000000000C00000C00000001
101001010010000010100100000011
101001001010101000100100001001
100000000000000C00000C00000001
101001010010000010100100001001
101001001010101000100100001001
100000000C00C00000000000000001
101001010010000010100100001001
101001001010101000100100001001
100000000000000C00000C00000001
101001010010000010100100001011
101001001010101000100100001001
1P0000000C00C000000000000000C1
101001001010101000100100001011
111111111111111111111111111111