1111111111111
10010000000C1
1008111110001
1P0011E0t0001
1111111111111