11111
10P01
10C01
11011
10E01
11111
