11111
10P01
10C01
100E1
10001
11111
