11111111
1P0000C1
10011101
1C0000E1
11111111
