111111
1P0001
1C0101
1000E1
111111
