1111111
1P0C001
1000001
1C000E1
1111111
