1111111
1P00001
101110C1
1C000E11
11111111
