1111111
1P000C1
1000101
1C000E1
1111111
