111111111111111111111111111111
100000000000000C00000C00000001
101001010010000010100100000011
101001001010101000100100001001
100000000000000C00000C00000001
101001010010000010100100001001
101001001010101000100100001001
100000000C00C00000000000000001
101001010010000010100100001001
101001001010101000100100001001
100000000000000C00000C00000001
101001010010000010100100001011
101001001010101000100100001111
1P0000000C00C0000000000000E0C1
101001001010101000100100001011
111111111111111111111111111111