111111111111
1000C0000011
100P01E01001
111111111111