11111111111111111111111111111
1P0000000C000001000111110CCC1
1111110111111101010000000C0C1
1C000000C0000100010111110CCC1
10111111110101111100000111111
101111C111010100C111110C00001
1000C100000101011100011111101
111111111111C1000001000C00001
1000000001C111111111101111011
101110110100001C1110000000001
1000100101111010111010101C1C1
11101101010000100000101011111
1C00C10100011111111110101C001
11111101110110001000101011101
11111101110110001000101011101
1E000001C00000100010001000001
11111111111111111111111111111